# number of crystal present
CrystalsN: 9

# crysid crymodule channelID crysBoard(HW) activecrys
0        0         0          B27           1      
1        0         1          B27           1 
2        0         2          B27           1 
3        0         3          B27           1 
4        0         4          B27           1 
5        0         5          B27           1 
6        0         6          B27           1 
7        0         7          B27           1 
8        0         8          B27           1 